NO ./sprites/bookshelf.xpm
SO ./sprites/eagle.xpm
WE ./sprites/obsidian.xpm
EA ./sprites/cobbelstone.xpm


F 220,100,0
C 173,216,255

        111111111111111111111111111
        10000000001100000000000011
        1011000001110000000000001
        1001000000000000000000001
111111111011000001110000000000001
100000000011000001110111111111111
11110111110001111100000010001
11110111111N111110000100010011
10000001101111111100000000011
10000000000000000100000010001
10000000000001000101010010001
11000001110101011111011010001
11110111 1110111 100000010001
11111111 1111111 111111111111
